######
#  @ #
#$####
# #
#.#
###

######
#@   #
#  $.#
# .# #
######

#####
#@  ##
#.$* #
#  # #
#    #
######

######
#@   ##
# $$  #
# #. .#
#     #
#######

  ####
###  #
#@ .$##
#   $ #
# #.  #
#     #
#######

 #####
##@  ##
#  #  #
# $*$ #
#  .  #
## . ##
 #####

######
#    ###
#   .. #
# $$$@ #
#  # . #
########

 #####
##.  ###
#  # $@#
#  # # #
# *  $.#
#    ###
######

######
#@*  ##
# $#  #
# $ . #
#.   ##
######

 ######
##    ##
# ..   #
# # $$$#
#   #@.#
########

######
#.@* ##
#$  $ #
#   # #
#  .  #
#######

######
#@ ..#
# #$ ##
# #   #
#  $# #
#  *  #
#######

#####
#   #
# # ###
#*.$  #
#  #$ #
#@   .#
#######

  #####
###  @#
#. *# #
#   $ #
# $. ##
######

######
#@   ##
# .$* ##
# #$.  #
#      #
########

######
#  . #
# #. ##
#  .  #
# $$$ #
#  # @#
#######

####
#  ####
#   *.#
#  $# #
#  .$@#
#######

#######
#  .  ##
# $$#. #
# #@$  #
#  .#  #
########

#######
#@   ##
# $$$ #
## ...#
#   # #
#     #
#######

####
#  ##
#   ##
#$ $@##
#. #$ #
#  . .#
#######