#######
#     #
#.$@$.#
#     #
#######

#######
#  @  #
#.$$  #
#  .  #
#######

###########
#.@ $   . #
#   #   ###
###########