8

######
#  @ #
#$####
# #!!!
#.#!!!
###!!!

######
#@   #
#  $.#
# .$ #
######

#####!
#@  ##
#.$* #
#  # #
#    #
######

######!
#@   ##
# $$  #
# #. .#
#     #
#######

!!####!
###  #!
#@ .$##
#   $ #
# #.  #
#     #
#######

!#####!
##@  ##
#  #  #
# $*$ #
#  .  #
## . ##
!#####!

######!!
#    ###
#   .. #
# $$$@ #
#  # . #
########

!#####!!
##.  ###
#  # $@#
#  # # #
# *  $.#
#    ###
######!!

######!
#@*  ##
# $#  #
# $ . #
#.   ##
######!

!######!
##    ##
# ..   #
# # $$$#
#   #@.#
########

######!
#.@* ##
#$  $ #
#   # #
#  .  #
#######

######!
#@ ..#!
# #$ ##
# #   #
#  $# #
#  *  #
#######

#####!!
#   #!!
# # ###
#*.$  #
#  #$ #
#@   .#
#######

!!#####
###  @#
#. *# #
#   $ #
# $. ##
######!

######!!
#@   ##!
# .$* ##
# #$.  #
#      #
########

######!
#  . #!
# #. ##
#  .  #
# $$$ #
#  # @#
#######

####!!!
#  ####
#   *.#
#  $# #
#  .$@#
#######

#######!
#  .  ##
# $$#. #
# #@$  #
#  .#  #
########

#######
#@   ##
# $$$ #
## ...#
#   # #
#     #
#######

####!!!
#  ##!!
#   ##!
#$ $@##
#. #$ #
#  . .#
#######

######
#   .#
#$$$@#
#. # #
#  . #
######

#######!
#     ##
# # #$ #
#. $*  #
#@  # .#
########

######!
#    ##
#@ #* #
#   $ #
#  $..#
#######

!!!#####
#### . #
#  $   #
#   ** #
# @  ###
######!!

!######!
##  . ##
#   $$@#
# #. $ #
#  .#  #
########

