WWWWW
W..TW
W.B.W
W.P.W
WWWWW

WWWWW
W.T.W
W.BPW
W...W
WWWWW

WWWWWW
WP...W
W..BTW
W.TB.W
WWWWWW

WWWWWW
W....WWW
W...TT.W
W.BBBP.W
W..W.T.W
WWWWWWWW